cutoff,R1,P1,RP11,RP10,RP01,RP00,precision,recall,f1score
1,884,2765,0,1881,0,884,,0.0,
2,884,2765,0,1881,0,884,,0.0,
3,884,2765,0,1881,0,884,,0.0,
4,884,2763,2,1879,0,884,1.0,0.001063264221158958,0.0021242697822623476
5,884,2752,10,1871,3,881,0.7692307692307693,0.00531632110579479,0.010559662090813094
6,884,2692,67,1814,6,878,0.9178082191780822,0.03561935140882509,0.06857727737973388
7,884,2573,184,1697,8,876,0.9583333333333334,0.09782030834662414,0.17752050168837435
8,884,2349,402,1479,14,870,0.9663461538461539,0.21371610845295055,0.3500217675228559
9,884,1798,936,945,31,853,0.96794208893485,0.49760765550239233,0.6573033707865169
10,884,1499,1221,660,45,839,0.9644549763033176,0.6491228070175439,0.7759771210676836
11,884,1383,1333,548,49,835,0.9645441389290883,0.7086656034024456,0.8170395341710083
12,884,1312,1403,478,50,834,0.9655884377150723,0.745879851143009,0.8416316736652669
13,884,1238,1476,405,51,833,0.9666011787819253,0.784688995215311,0.8661971830985916
14,884,1192,1520,361,53,831,0.9663064208518753,0.8080808080808081,0.8801389693109438
15,884,1171,1540,341,54,830,0.9661229611041405,0.8187134502923976,0.8863309352517986
16,884,1141,1568,313,56,828,0.9655172413793104,0.8335991493886231,0.8947218259629102
17,884,1119,1590,291,56,828,0.9659781287970839,0.8452950558213717,0.9016161043379642
18,884,1102,1607,274,56,828,0.9663259170174384,0.8543328017012227,0.9068848758465011
19,884,1094,1615,266,56,828,0.9664871334530222,0.8585858585858586,0.9093468468468467
20,884,1082,1626,255,57,827,0.966131907308378,0.8644338118022329,0.9124579124579125
21,884,1071,1637,244,57,827,0.9663518299881936,0.8702817650186071,0.9158041958041958
22,884,1065,1643,238,57,827,0.9664705882352941,0.873471557682084,0.9176207763194639
23,884,1060,1648,233,57,827,0.9665689149560117,0.8761297182349814,0.9191299498047965
24,884,1059,1649,232,57,827,0.9665885111371629,0.8766613503455609,0.919431279620853
25,884,1052,1656,225,57,827,0.9667250437828371,0.8803827751196173,0.9215358931552587
26,884,1047,1660,221,58,826,0.9662398137369034,0.8825093035619351,0.9224784662406225
27,884,1042,1664,217,59,825,0.9657573998839234,0.8846358320042531,0.9234184239733628
28,884,1036,1670,211,59,825,0.9658762290341237,0.88782562466773,0.925207756232687
29,884,1032,1674,207,59,825,0.9659549913444894,0.8899521531100478,0.9263973436635307
30,884,1029,1677,204,59,825,0.9660138248847926,0.8915470494417863,0.9272878075753386
31,884,1027,1679,202,59,825,0.9660529344073648,0.8926103136629452,0.9278806300082896
32,884,1023,1683,198,59,825,0.9661308840413318,0.8947368421052632,0.9290643113441899
33,884,1019,1687,194,59,825,0.9662084765177549,0.896863370547581,0.9302453818582851
34,884,1016,1690,191,59,825,0.9662664379645511,0.8984582668793195,0.931129476584022
35,884,1013,1693,188,59,825,0.966324200913242,0.900053163211058,0.9320121112028626
36,884,1009,1697,184,59,825,0.9664009111617312,0.9021796916533759,0.9331866923288424
37,884,1009,1697,184,59,825,0.9664009111617312,0.9021796916533759,0.9331866923288424
38,884,1007,1699,182,59,825,0.9664391353811149,0.9032429558745348,0.9337730145644407
39,884,1006,1700,181,59,825,0.9664582148948266,0.9037745879851143,0.9340659340659342
40,884,1001,1704,177,60,824,0.9659863945578231,0.9059011164274322,0.9349794238683128
41,884,998,1706,175,61,823,0.9654782116581777,0.9069643806485912,0.9353070175438596
42,884,995,1708,173,62,822,0.9649717514124294,0.9080276448697502,0.9356340728567516
43,884,993,1709,172,63,821,0.9644469525959368,0.9085592769803296,0.9356693128935122
44,884,989,1712,169,64,820,0.963963963963964,0.910154173312068,0.9362865736942849
45,884,987,1713,168,65,819,0.9634420697412823,0.9106858054226475,0.9363213992894234
46,884,983,1716,165,66,818,0.9629629629629629,0.9122807017543859,0.9369369369369369
47,884,979,1718,163,68,816,0.961926091825308,0.9133439659755449,0.9370057267521135
48,884,978,1718,163,69,815,0.9613878007834359,0.9133439659755449,0.9367502726281351
49,884,978,1718,163,69,815,0.9613878007834359,0.9133439659755449,0.9367502726281351
50,884,974,1719,162,72,812,0.9597989949748744,0.9138755980861244,0.9362745098039217
51,884,969,1721,160,75,809,0.9582405345211581,0.9149388623072834,0.9360892031547456
52,884,958,1723,158,84,800,0.9535141117874931,0.9160021265284424,0.9343817787418657
53,884,949,1726,155,90,794,0.9504405286343612,0.9175970228601807,0.9337300513930213
54,884,935,1730,151,100,784,0.9453551912568307,0.9197235513024987,0.9323632444085153
55,884,924,1734,147,107,777,0.9418794133623031,0.9218500797448166,0.9317571198280494
56,884,901,1737,144,127,757,0.9318669527896996,0.9234449760765551,0.9276368491321763
57,884,890,1741,140,134,750,0.9285333333333333,0.9255715045188729,0.9270500532481363
58,884,871,1748,133,146,738,0.9229144667370645,0.9292929292929293,0.9260927152317882
59,884,853,1755,126,157,727,0.9178870292887029,0.9330143540669856,0.9253888742420248
60,884,833,1766,115,166,718,0.9140786749482401,0.93886230728336,0.926304746918437
61,884,805,1774,107,186,698,0.9051020408163265,0.9431153641679958,0.9237177818276491
62,884,775,1784,97,206,678,0.8964824120603015,0.9484316852737905,0.921725652286231
63,884,744,1792,89,229,655,0.8866897575457694,0.9526847421584264,0.9185033316248078
64,884,710,1805,76,250,634,0.878345498783455,0.9595959595959596,0.9171747967479674
65,884,685,1812,69,268,616,0.8711538461538462,0.9633173843700159,0.9149204746276194
66,884,641,1824,57,300,584,0.8587570621468926,0.9696969696969697,0.9108614232209737
67,884,610,1835,46,320,564,0.851508120649652,0.9755449229133439,0.9093161546085233
68,884,595,1840,41,330,554,0.847926267281106,0.9782030834662414,0.908417674648235
69,884,567,1846,35,352,532,0.8398544131028207,0.9813928761297183,0.9051238048541309
70,884,550,1849,32,366,518,0.834762979683973,0.9829877724614566,0.90283203125
71,884,535,1852,29,378,506,0.8304932735426009,0.9845826687931951,0.9009973242520068
72,884,516,1858,23,391,493,0.8261449533125834,0.987772461456672,0.8997578692493946
73,884,494,1866,15,405,479,0.821664464993395,0.9920255183413078,0.8988439306358382
74,884,481,1867,14,417,467,0.8174255691768827,0.9925571504518873,0.8965186074429771
75,884,473,1870,11,422,462,0.8158813263525305,0.9941520467836257,0.8962377186676252
76,884,466,1870,11,429,455,0.8133971291866029,0.9941520467836257,0.8947368421052633
77,884,454,1874,7,437,447,0.8109043704024232,0.9962785752259437,0.8940839694656489
78,884,447,1879,2,439,445,0.8106125970664366,0.998936735778841,0.8949749940462015
79,884,438,1879,2,448,436,0.807477438762355,0.998936735778841,0.8930608365019013
80,884,432,1879,2,454,430,0.8054007715387913,0.998936735778841,0.8917892738490746
81,884,427,1879,2,459,425,0.8036783575705732,0.998936735778841,0.8907324010429011
82,884,415,1879,2,471,413,0.7995744680851063,0.998936735778841,0.8882060978492081
83,884,396,1879,2,490,394,0.7931616715913887,0.998936735778841,0.884235294117647
84,884,376,1879,2,510,374,0.7865215571368773,0.998936735778841,0.8800936768149883
85,884,366,1879,2,520,364,0.7832430179241351,0.998936735778841,0.8780373831775701
86,884,354,1880,1,531,353,0.7797594359187059,0.9994683678894205,0.8760484622553587
87,884,335,1880,1,550,334,0.7736625514403292,0.9994683678894205,0.8721874275110183
88,884,318,1880,1,567,317,0.768287699223539,0.9994683678894205,0.8687615526802217
89,884,296,1880,1,589,295,0.7614418793033617,0.9994683678894205,0.8643678160919541
90,884,280,1880,1,605,279,0.7565392354124748,0.9994683678894205,0.8612001832340815
91,884,256,1880,1,629,255,0.749302510960542,0.9994683678894205,0.856492027334852
92,884,219,1881,0,665,219,0.7388059701492538,1.0,0.8497854077253219
93,884,185,1881,0,699,185,0.7290697674418605,1.0,0.8433086751849361
94,884,147,1881,0,737,147,0.7184873949579832,1.0,0.8361858190709046
95,884,93,1881,0,791,93,0.7039670658682635,1.0,0.8262683944651878
96,884,42,1881,0,842,42,0.6907822254865956,1.0,0.8171155516941789
97,884,7,1881,0,877,7,0.6820159535895577,1.0,0.8109506359129123
98,884,0,1881,0,884,0,0.6802893309222423,1.0,0.8097287989668532
99,884,0,1881,0,884,0,0.6802893309222423,1.0,0.8097287989668532
